
afar : "afr, conjClass, mainStem, morphClass, pdgmType, polarity, tam"
akkadian-ob : "aob, ablautClass, derivedStem, morphClass, rootClass, tam"
alaaba : "alb, causativeAllomorph, derivedStem, morphClass, pdgmType, stemFinalC"
arabic : "arb, derivedStem, infinitiveVar, morphClass, rootClass, state, voice"
arbore : "abr, conjClass, derivedStem, infinitiveClass, morphClass, morphoSynEnv, nonFiniteForm, patternClass, pdgmType, stemAltClass, subconjClass"
awngi : "awn, NO_PDGM"
bayso : "bay, conjClass, formType, morphClass, tam, tamStemForm"
beja-arteiga : "bar, conjClass, conjType, derivedStem, derivedStemAug, formType, morphClass, nonFiniteForm, participle, pdgmType, polarity, rootClass, tam, tamStemClass"
beja-atmaan : "bat, caseHead, clauseType, conjClass, conjSubType, formFrequency, genderHead, headPosition, morphClass, nonFiniteForm, pdgmType, polarity, rootClass"
beja-beniamer : "bbe, conjClass, derivedStem, derivedStemAug, morphClass, pdgmType, polarity, stemType, tam"
beja-bishari : "bbi, conjClass, morphClass, rootClass"
beja-hadendowa : "bha, aspect, conjClass, derivedStem, mood, morphClass, nomForm, nonFiniteForm, polarity, rootClass, tam, verbMorphClass"
bilin : "bil, conjClass, copType, derivedStem, morphClass, nonFiniteForm, polarity, tam"
boni-jara : "boj, cliticClass, cliticType, conjClass, formType, morphClass, polarity, tam, verbMorphClass"
boni-kijee-bala : "bob, conjClass, morphClass, polarity, tam"
boni-kilii : "bok, conjClass, deAdjClass, formType, morphClass, polarity, tam, type, verbMorphClass"
burji : "bur, conjClass, derivedStem, formType, morphClass, polarity, present, proType, suppletion, tam, verbClass"
burunge : "brn, affirmationType, derivedStem, genderHead, gramFunction, imprtvComponent, morphClass, orientationSel, tam, tenseSel"
coptic-sahidic : "csa, clauseConjugation, imperativeForm, infinitiveForm, morphClass, objectGender, objectNumber, objectPerson, objectType, polarity, stemClass, tam, transitivity"
dahalo : "dah, morphClass, selector, selectorPosition"
dhaasanac : "dha,Error 503: The query timed out (restricted to null ms)Fuseki - version 1.0.1 (Build date: 2014-01-18T19:01:20+0000)
dizi : "diz, derivedStem, morphClass, nonMainForm, tam"
egyptian-middle : "egm, NO_PDGM"
elmolo : "elm, conjClass, final, statusClass"
gawwada : "gaw, derivedStem, inflClass, morphClass, pdgmType, tam"
gedeo : "ged, NO_PDGM"
geez : "gez, derivedClass, derivedStem, morphClass, rootClass, stemClass, tam"
hadiyya : "had, derivedStem, morphClass"
hebrew : "heb, ablautClass, rootClass"
iraqw : "irq, category, conjClass, derivedStem, genderHead, genderObj, imprtvClass, morphClass, numHead, numObj, numSubj, persObj, persSubj, polarity, posHead, selectorBE, selectorCategory, selectorClass, selectorMood, selectorTense, tam"
kambaata : "kam, class, morphClass"
kemant : "kem, derivedStem, finiteForm, morphClass, pdgmSubType, pdgmType, polarity"
khamtanga : "khm, conjClass"
koorete : "kor, conjClass, derivedStem, morphClass"
maale : "mal, derivedStem, morphClass, polarity, rootStructure, tam, temporal"
oromo : "orm, copType, derivedStem, nonFiniteForm, pdgmSubType, polarity, tam"
rendille : "ren, conjClass, conjSubType, derivedStem"
saho : "sah, conjClass"
shinassha : "shn, complement, conjClass, derivedStem, morphClass, polarity, tam, vClass"
sidaama : "sid, derivedStem, morphClass"
somali-standard : "sst, clauseCase, clauseType, conjClass, conjSubClass, morphClass, nonFiniteForm, numPersGender, pdgmSubType, pdgmType, polarity, prefix, subConj, tam"
syriac : "syr, NO_PDGM"
tsamakko : "tsm, conj, conjClass, derivedClass, derivedStem, morphClass, polarity, suffixSet, tam"
wolaytta : "wol, complement, derived, mood, morphClass, polarity, tam, vClass"
yaaku : "yak, aspect, conjClass, morphClass, polarity, tam"
yemsa : "yem, conjClass, derived, morphClass, polarity, tam, templ"
