
afar : "afr, NO_PDGM"
akkadian-ob : "aob, NO_PDGM"
alaaba : "alb, NO_PDGM"
arabic : "arb, NO_PDGM"
arbore : "abr, NO_PDGM"
awngi : "awn, NO_PDGM"
bayso : "bay, NO_PDGM"
beja-arteiga : "bar, case, morphClass, pdgmType, pluralClass, postpositionClass"
beja-atmaan : "bat, NO_PDGM"
beja-beniamer : "bbe, NO_PDGM"
beja-bishari : "bbi, NO_PDGM"
beja-hadendowa : "bha, gender, genderHead, genderN1, genderN2, genderPoss, morphClass, nounMorphClass, numN1, numPoss"
bilin : "bil, NO_PDGM"
boni-jara : "boj, NO_PDGM"
boni-kijee-bala : "bob, NO_PDGM"
boni-kilii : "bok, NO_PDGM"
burji : "bur, NO_PDGM"
burunge : "brn, morphClass, predType"
coptic-sahidic : "csa, NO_PDGM"
dahalo : "dah, NO_PDGM"
dhaasanac : "dha, NO_PDGM"
dizi : "diz, NO_PDGM"
egyptian-middle : "egm, NO_PDGM"
elmolo : "elm, NO_PDGM"
gawwada : "gaw, NO_PDGM"
gedeo : "ged, NO_PDGM"
geez : "gez, NO_PDGM"
hadiyya : "had, NO_PDGM"
hebrew : "heb, NO_PDGM"
iraqw : "irq, NO_PDGM"
kambaata : "kam, NO_PDGM"
kemant : "kem, nounClass"
khamtanga : "khm, morphClass, numClass"
koorete : "kor, NO_PDGM"
maale : "mal, NO_PDGM"
oromo : "orm, NO_PDGM"
rendille : "ren, NO_PDGM"
saho : "sah, NO_PDGM"
shinassha : "shn, NO_PDGM"
sidaama : "sid, NO_PDGM"
somali-standard : "sst, NO_PDGM"
syriac : "syr, NO_PDGM"
tsamakko : "tsm, NO_PDGM"
wolaytta : "wol, NO_PDGM"
yaaku : "yak, conjClass, gender, number, proClass"
yemsa : "yem, NO_PDGM"
