
afar : "afr, case, gender, number, person, proClass"
akkadian-ob : "aob, case, deixis, gender, genderHead, numHead, number, person, proClass"
alaaba : "alb, case, gender, genderHead, number, person, proClass"
arabic : "arb, case, deixis, gender, number, person, proClass"
arbore : "abr, case, defClass, deixis, gender, genderPoss, mood, numPoss, number, person, polarity, proClass, selectorProClass, suffixType, tam"
awngi : "awn, NO_PDGM"
bayso : "bay, case, gender, number, person, proClass"
beja-arteiga : "bar, case, defClass, deixis, gender, langVar, morphClass, number, pdgmType, person, proClass"
beja-atmaan : "bat, case, gender, genderHead, genderPoss, numHead, number, person, proClass"
beja-beniamer : "bbe, case, gender, genderHead, genderPoss, numHead, number, person, proClass, stemFinal"
beja-bishari : "bbi, case, caseHead, gender, genderCop, genderHead, genderP1, genderPoss, numCop, numHead, numP1, numP2, numPoss, number, pdgmType, persCop, persP1, persP2, person, proClass, tam"
beja-hadendowa : "bha, case, gender, genderHead, genderPoss, morphClass, numHead, numPoss, number, pdgmType, person, proClass"
bilin : "bil, case, gender, number, person, proClass"
boni-jara : "boj, formType, gender, number, person, proClass"
boni-kijee-bala : "bob, NO_PDGM"
boni-kilii : "bok, formType, gender, number, person, proClass"
burji : "bur, case, caseHead, deixis, gender, genderHead, interrogClass, number, person, proClass, type"
burunge : "brn, affirmationType, case, deixis, gender, genderHead, number, person, proClass, reference, type"
coptic-sahidic : "csa, gender, genderHead, morphClass, number, numberHead, person, proClass"
dahalo : "dah, gender, number, person, proClass, type"
dhaasanac : "dha, case, cohesion, emphatic, number, person, proClass"
dizi : "diz, case, gender, number, person, proClass"
egyptian-middle : "egm, gender, number, person, proClass"
elmolo : "elm, gender, number, person, proClass, synEnv"
gawwada : "gaw, gender, genderHead, number, person, polarity, proClass"
gedeo : "ged, case, caseHead, deixis, gender, genderHead, interrogClass, number, person, proClass"
geez : "gez, NO_PDGM"
hadiyya : "had, case, deixis, gender, interrogClass, number, numgen, person, proClass"
hebrew : "heb, case, deixis, gender, numHead, number, person, proClass, tenseHead"
iraqw : "irq, demonstrative, form, gender, headGen, number, person, proClass"
kambaata : "kam, case, deixis, gender, interrogClass, number, proClass"
kemant : "kem, gender, number, person, proClass, proSet"
khamtanga : "khm, case, deixis, gender, number, person, proClass"
koorete : "kor, case, dimension, gender, number, person, proClass"
maale : "mal, case, gender, number, person, possType, proClass"
oromo : "orm, case, gender, number, person, proClass"
rendille : "ren, case, cliticType, cohesion, deixis, focus, gender, number, person, proClass"
saho : "sah, case, gender, number, person, proClass"
shinassha : "shn, case, gender, number, person, proClass"
sidaama : "sid, case, deixis, direction, gender, interrogClass, number, person, posClass, proClass"
somali-standard : "sst, case, conjSubType, gender, genderPoss, number, person, proClass"
syriac : "syr, case, deixis, gender, numHead, number, person, proClass"
tsamakko : "tsm, case, category, defMarker, deixis, gender, genderObj, numObj, number, person, proClass"
wolaytta : "wol, case, gender, genderRef, number, person, proClass"
yaaku : "yak, conjClass, gender, headNoun, number, person, proClass"
yemsa : "yem, case, gender, number, person, proClass"
