
afar : "afr, conjClass, formType, pdgmSubType, pdgmType, polarity, tam"
akkadian-ob : "aob, ablautClass, derivedStem, morphClass, rootClass, tam"
alaaba : "alb, clauseType, morphClass, polarity, tam"
arabic : "arb, aspect, derivedStem, mood, tam, voice"
arbore : "abr, clauseType, conjClass, derivedStem, formType, patternClass, pdgmType, polarity, stemClass, subconjClass, tam"
awngi : "awn, clauseType, defClass, morphClass, polarity, tam, varB, varClass"
bayso : "bay, conjClass, morphClass, polarity, tam"
beja-arteiga : "bar, conjClass, derivedStem, derivedStemAug, formType, morphClass, pdgmType, polarity, rootClass, tam"
beja-atmaan : "bat, conjClass, conjSubType, derivedStemAug, morphClass, pdgmType, polarity, rootClass, stemClass, strength, tam"
beja-beniamer : "bbe, conjClass, conjSubType, morphClass, pdgmSubType, pdgmType, polarity, rootClass, stemClass, tam, type"
beja-bishari : "bbi, conjClass, derivedStem, morphClass, nonFiniteForm, polarity, proClass, rootClass, tam"
beja-hadendowa : "bha, clause, clauseType, conjClass, derivedStem, morphClass, nonFiniteForm, polarity, rootClass, tam, verbMorphClass"
bilin : "bil, aspect, clauseType, conjClass, morphClass, numberGenderHead, pdgmType, pngSet, polarity, tam, verbMorphClass"
boni-jara : "boj, aspect, conjClass, formType, mood, polarity, tam, verbMorphClass"
boni-kijee-bala : "bob, conjClass, polarity, tam"
boni-kilii : "bok, aspect, cliticClass, cliticType, conjClass, deAdjClass, formType, mood, polarity, tam, type, verbMorphClass"
burji : "bur, clauseMarker, conjClass, derivedStem, focus, formType, morphClass, pdgmType, polarity, proType, tam, verbClass"
burunge : "brn, affirmationType, clauseTypeSel, derivedStem, genderHead, genderObj, morphClass, numObj, numSubj, orientationSel, polarity, predType, stemClass, stemInflCategory, stemInflMorpheme, tam, tenseSel"
coptic-sahidic : "csa, clauseConjugation, clauseType, formClass, polarity, stemClass, tam"
dahalo : "dah, aspect, polarity, tam"
dhaasanac : "dha, conjClass, derivedStem, derivedStemAug, extended, formType, morphClass, nonFiniteForm, pdgmSubType, pdgmType, polarity, tam, verbMorphClass, verbType"
dizi : "diz, morphClass, polarity, tam"
egyptian-middle : "egm, NO_PDGM"
elmolo : "elm, conjClass, derivedCategory, patternClass, polarity, position, tam, verbMorphClass"
gawwada : "gaw, inflClass, morphClass, pdgmType, polarity, tam, tense2"
gedeo : "ged, polarity, tam"
geez : "gez, conjugation, derivedStem, morphClass, rootClass, stemClass, tam"
hadiyya : "had, morphClass, polarity, tam"
hebrew : "heb, ablautClass, derivedStem, morphClass, rootClass, tam"
iraqw : "irq, conjClass, mood, morphClass, polarity, selectorBE, tam"
kambaata : "kam, morphClass, polarity, tam"
kemant : "kem, aspect, formType, genderHeadRel, morphClass, numHeadRel, pdgmSubType, pdgmType, polarity, tam, vSubjectSet"
khamtanga : "khm, clauseType, conjClass, genderHead, genderPoss, numHead, polarity, tam"
koorete : "kor, conjClass, focus, pdgmClass, polarity, tam"
maale : "mal, clauseType, modal, polarity, tam"
oromo : "orm, clauseType, derivedStem, formType, polarity, tam"
rendille : "ren, clauseType, conjClaspdgmLexs, conjClass, conjSubType, derivedStem, polarity, tam"
saho : "sah, conjClass, derivedStem, nonFiniteForm, polarity, tam"
shinassha : "shn, complement, conjClass, mood, morphClass, polarity, tam"
sidaama : "sid, aspect, clauseType, configuration, morphClass, pdgmType, polarity, tam"
somali-standard : "sst, clauseCase, clauseType, conjClass, conjSubClass, pdgmType, polarity, tam"
syriac : "syr, NO_PDGM"
tsamakko : "tsm, conjClass, morphClass, polarity, stemShape, suffixSet, tam"
wolaytta : "wol, complement, mood, morphClass, polarity, tam"
yaaku : "yak, aspect, case, conjClass, copForm, morphClass, polarity, tam"
yemsa : "yem, conjClass, morphClass, polarity, tam"
